{
  "id": "arnhem_rail_bridge",
  "name": "Arnhem Rail Bridge — The Rhine Crossing",
  "width": 38,
  "height": 32,
  "tiles": [
    [5, 5, 1, 1, 1, 1, 1, 1, 1, 1, 1, 1, 1, 1, 1, 1, 1, 1, 1, 1, 1, 1, 1, 1, 1, 1, 1, 1, 1, 1, 1, 1, 1, 1, 1, 5, 5, 5],
    [5, 4, 1, 1, 1, 1, 1, 1, 1, 1, 1, 1, 1, 1, 1, 1, 1, 1, 1, 1, 1, 1, 1, 1, 1, 1, 1, 1, 1, 1, 1, 1, 1, 1, 1, 4, 5, 5],
    [4, 4, 5, 1, 1, 5, 5, 4, 4, 5, 1, 1, 5, 4, 4, 5, 5, 4, 1, 1, 4, 5, 5, 4, 4, 5, 1, 1, 5, 4, 4, 5, 5, 1, 1, 4, 4, 5],
    [4, 5, 4, 1, 1, 4, 5, 4, 5, 4, 1, 1, 4, 5, 4, 4, 5, 4, 1, 1, 5, 4, 5, 4, 5, 4, 1, 1, 4, 5, 4, 4, 5, 1, 1, 5, 4, 4],
    [4, 4, 1, 1, 1, 4, 4, 4, 4, 1, 1, 1, 4, 4, 4, 4, 4, 1, 1, 1, 4, 4, 4, 4, 4, 1, 1, 1, 4, 4, 4, 4, 1, 1, 1, 4, 4, 4],
    [4, 1, 1, 4, 1, 1, 4, 4, 1, 1, 4, 1, 1, 4, 4, 4, 1, 1, 4, 1, 1, 4, 4, 4, 1, 1, 4, 1, 1, 4, 4, 1, 1, 4, 1, 1, 4, 4],
    [4, 1, 1, 4, 1, 1, 4, 4, 1, 1, 4, 1, 1, 4, 5, 4, 1, 1, 4, 1, 1, 4, 5, 4, 1, 1, 4, 1, 1, 4, 4, 1, 1, 4, 1, 1, 4, 4],
    [4, 4, 1, 1, 1, 4, 4, 1, 1, 1, 4, 4, 1, 1, 4, 4, 1, 1, 1, 4, 4, 1, 1, 4, 4, 1, 1, 1, 4, 4, 1, 1, 1, 4, 4, 1, 1, 4],
    [4, 4, 1, 1, 0, 4, 5, 1, 1, 0, 4, 4, 1, 1, 5, 4, 1, 1, 0, 5, 4, 4, 1, 1, 5, 4, 1, 1, 0, 4, 5, 1, 1, 0, 4, 4, 1, 4],
    [4, 1, 1, 0, 0, 1, 4, 1, 1, 0, 0, 1, 1, 4, 4, 1, 1, 0, 0, 1, 1, 4, 4, 1, 1, 0, 0, 1, 1, 4, 1, 1, 0, 0, 1, 1, 4, 4],
    [5, 1, 1, 0, 0, 1, 5, 1, 1, 0, 0, 1, 5, 5, 1, 1, 0, 0, 1, 5, 5, 1, 1, 0, 0, 1, 5, 1, 1, 0, 0, 1, 5, 1, 1, 0, 5, 4],
    [5, 5, 1, 1, 0, 5, 5, 0, 0, 1, 1, 5, 5, 5, 0, 0, 1, 1, 5, 5, 5, 0, 0, 1, 1, 5, 5, 0, 0, 1, 1, 5, 5, 1, 1, 0, 5, 5],
    [6, 6, 6, 6, 6, 6, 6, 6, 6, 6, 6, 6, 6, 6, 6, 6, 6, 6, 12, 12, 12, 6, 6, 6, 6, 6, 6, 6, 6, 11, 11, 6, 6, 6, 6, 6, 6, 6],
    [6, 6, 6, 6, 6, 6, 6, 6, 6, 6, 6, 6, 6, 6, 6, 6, 6, 6, 12, 12, 12, 6, 6, 6, 6, 6, 6, 6, 6, 11, 6, 6, 6, 6, 6, 6, 6, 6],
    [6, 6, 6, 6, 6, 6, 6, 6, 6, 6, 6, 6, 6, 6, 6, 6, 6, 6, 12, 12, 12, 6, 6, 6, 6, 6, 6, 6, 6, 11, 11, 6, 6, 6, 6, 6, 6, 6],
    [6, 6, 6, 6, 6, 6, 6, 6, 6, 6, 6, 6, 6, 6, 6, 6, 6, 6, 12, 12, 12, 6, 6, 6, 6, 6, 6, 6, 6, 6, 6, 6, 6, 6, 6, 6, 6, 6],
    [0, 0, 2, 2, 0, 0, 2, 2, 0, 0, 5, 5, 0, 0, 2, 2, 0, 0, 1, 1, 0, 0, 2, 2, 0, 0, 5, 5, 0, 0, 1, 1, 0, 0, 2, 2, 0, 0],
    [2, 2, 0, 0, 2, 2, 0, 0, 5, 5, 0, 0, 2, 2, 0, 0, 1, 1, 1, 1, 1, 1, 1, 1, 1, 1, 0, 0, 2, 2, 1, 1, 1, 1, 2, 2, 0, 0],
    [2, 0, 0, 2, 2, 0, 0, 2, 5, 0, 0, 2, 2, 0, 0, 1, 1, 1, 1, 1, 1, 1, 1, 1, 1, 0, 0, 2, 2, 1, 1, 1, 1, 1, 1, 2, 0, 0],
    [0, 0, 2, 2, 0, 0, 2, 0, 0, 2, 2, 0, 0, 1, 1, 1, 1, 2, 2, 0, 0, 2, 2, 1, 1, 1, 1, 0, 0, 2, 2, 0, 0, 2, 2, 0, 0, 2],
    [2, 2, 0, 0, 2, 2, 0, 0, 2, 0, 0, 2, 1, 1, 2, 2, 0, 0, 2, 2, 0, 0, 2, 2, 0, 0, 2, 2, 0, 0, 2, 0, 0, 2, 0, 0, 2, 2],
    [2, 0, 0, 2, 2, 0, 0, 2, 0, 0, 2, 1, 1, 2, 0, 0, 2, 2, 0, 0, 2, 2, 0, 0, 2, 0, 0, 2, 0, 0, 2, 0, 0, 2, 2, 0, 0, 2],
    [0, 0, 2, 2, 0, 0, 2, 0, 0, 2, 1, 1, 2, 0, 0, 2, 2, 0, 0, 2, 0, 0, 2, 2, 0, 0, 2, 0, 0, 2, 0, 0, 2, 2, 0, 0, 2, 0],
    [2, 2, 0, 0, 2, 7, 7, 0, 0, 2, 1, 2, 0, 0, 2, 7, 7, 0, 0, 2, 2, 0, 0, 2, 7, 7, 0, 0, 2, 2, 0, 0, 2, 7, 7, 0, 0, 2],
    [2, 0, 0, 2, 7, 7, 2, 0, 0, 2, 1, 2, 0, 0, 2, 7, 7, 2, 0, 0, 2, 0, 0, 2, 7, 7, 2, 0, 0, 2, 0, 0, 2, 7, 7, 2, 0, 0],
    [0, 0, 2, 7, 7, 2, 0, 0, 2, 2, 1, 2, 0, 0, 2, 7, 7, 2, 0, 0, 2, 0, 0, 2, 7, 7, 2, 0, 0, 2, 0, 0, 2, 7, 7, 2, 0, 0],
    [2, 2, 0, 7, 2, 0, 0, 2, 2, 0, 1, 2, 2, 0, 0, 7, 2, 0, 0, 2, 2, 0, 0, 7, 2, 0, 0, 2, 2, 0, 0, 7, 2, 0, 0, 2, 2, 0],
    [0, 0, 2, 2, 0, 0, 2, 0, 0, 2, 1, 2, 0, 0, 2, 2, 0, 0, 2, 0, 0, 2, 0, 0, 2, 2, 0, 0, 2, 0, 0, 2, 2, 0, 0, 2, 0, 0],
    [2, 2, 0, 0, 2, 2, 0, 0, 2, 0, 1, 0, 2, 2, 0, 0, 2, 2, 0, 0, 2, 2, 0, 0, 2, 2, 0, 0, 2, 2, 0, 0, 2, 2, 0, 0, 2, 2],
    [2, 0, 0, 2, 2, 0, 0, 2, 0, 0, 1, 0, 0, 2, 2, 0, 0, 2, 0, 0, 2, 0, 0, 2, 2, 0, 0, 2, 0, 0, 2, 2, 0, 0, 2, 0, 0, 2],
    [0, 0, 2, 2, 0, 0, 2, 0, 0, 2, 1, 2, 0, 0, 2, 2, 0, 0, 2, 0, 0, 2, 0, 0, 2, 2, 0, 0, 2, 0, 0, 2, 2, 0, 0, 2, 0, 0],
    [2, 2, 0, 0, 2, 0, 0, 2, 2, 0, 1, 0, 2, 2, 0, 0, 2, 0, 0, 2, 2, 0, 0, 2, 0, 0, 2, 2, 0, 0, 2, 0, 0, 2, 0, 0, 2, 2]
  ],
  "objectives": [
    {
      "id": "rail_bridge_ruins",
      "name": "Rail Bridge Ruins",
      "position": [19, 13],
      "radius": 2,
      "value": 40,
      "required": true
    },
    {
      "id": "pontoon_bridge",
      "name": "Pontoon Bridge",
      "position": [29, 13],
      "radius": 2,
      "value": 30,
      "required": true
    },
    {
      "id": "northern_bank",
      "name": "Northern Bank",
      "position": [19, 8],
      "radius": 3,
      "value": 20,
      "required": false
    },
    {
      "id": "southern_bank",
      "name": "Southern Bank",
      "position": [19, 18],
      "radius": 3,
      "value": 20,
      "required": false
    },
    {
      "id": "industrial_quarter",
      "name": "Industrial Quarter",
      "position": [12, 6],
      "radius": 2,
      "value": 10,
      "required": false
    },
    {
      "id": "river_crossing_point",
      "name": "River Crossing Point",
      "position": [29, 17],
      "radius": 2,
      "value": 20,
      "required": false
    }
  ],
  "spawn_points": [
    {
      "id": "spawn_allies_frost",
      "side": "allies",
      "name": "British 2nd Para - Frost's Approach",
      "position": [19, 20],
      "units_max": 12
    },
    {
      "id": "spawn_axis_german",
      "side": "axis",
      "name": "German Defenders - Arnhem City",
      "position": [19, 4],
      "units_max": 12
    },
    {
      "id": "spawn_allies_reinforcement",
      "side": "allies",
      "name": "Allied Reinforcement - Southwest Approach",
      "position": [10, 25],
      "units_max": 8
    }
  ]
}
